#########
#A #   #
# # # #
#   # #
### # #
#     B#
#########
